{
    "None": 0,
    "P6": 30,
    "P17": 2,
    "P19": 7,
    "P20": 25,
    "P22": 35,
    "P25": 34,
    "P26": 33,
    "P27": 5,
    "P30": 12,
    "P31": 83,
    "P35": 77,
    "P36": 32,
    "P37": 37,
    "P39": 57,
    "P40": 36,
    "P50": 70,
    "P54": 69,
    "P57": 48,
    "P58": 49,
    "P69": 26,
    "P86": 63,
    "P102": 43,
    "P108": 28,
    "P112": 85,
    "P118": 56,
    "P123": 86,
    "P127": 55,
    "P131": 3,
    "P136": 72,
    "P137": 84,
    "P140": 78,
    "P150": 4,
    "P155": 51,
    "P156": 52,
    "P159": 1,
    "P161": 23,
    "P162": 75,
    "P166": 29,
    "P170": 61,
    "P171": 91,
    "P172": 8,
    "P175": 21,
    "P176": 87,
    "P178": 40,
    "P179": 59,
    "P190": 96,
    "P194": 53,
    "P205": 73,
    "P206": 15,
    "P241": 54,
    "P264": 18,
    "P272": 50,
    "P276": 13,
    "P279": 82,
    "P355": 89,
    "P361": 31,
    "P364": 80,
    "P400": 41,
    "P403": 24,
    "P449": 62,
    "P463": 20,
    "P488": 64,
    "P495": 16,
    "P527": 19,
    "P551": 17,
    "P569": 6,
    "P570": 27,
    "P571": 9,
    "P576": 10,
    "P577": 22,
    "P580": 66,
    "P582": 67,
    "P585": 44,
    "P607": 11,
    "P674": 58,
    "P676": 68,
    "P706": 74,
    "P710": 76,
    "P737": 81,
    "P740": 45,
    "P749": 88,
    "P800": 39,
    "P807": 95,
    "P840": 71,
    "P937": 42,
    "P1001": 47,
    "P1056": 92,
    "P1198": 90,
    "P1336": 79,
    "P1344": 65,
    "P1365": 94,
    "P1366": 93,
    "P1376": 14,
    "P1412": 38,
    "P1441": 60,
    "P3373": 46
}